Name	Surname	E-mail
John	Doe	john.doe@corp.com
Jane	Smith	jane.smith@corp.com
Alice	Jones	alice.jones@corp.com
Robert	Brown	robert.brown@corp.com
Emma	Wilson	emma.wilson@corp.com
Michael	Davis	michael.davis@corp.com
Olivia	Martinez	olivia.martinez@corp.com
William	Anderson	william.anderson@corp.com
Sophia	Thomas	sophia.thomas@corp.com
James	Taylor	james.taylor@corp.com
Isabella	Moore	isabella.moore@corp.com
Benjamin	Jackson	benjamin.jackson@corp.com
Mia	White	mia.white@corp.com
Daniel	Harris	daniel.harris@corp.com
Charlotte	Clark	charlotte.clark@corp.com
Matthew	Lewis	matthew.lewis@corp.com
Amelia	Robinson	amelia.robinson@corp.com
David	Walker	david.walker@corp.com
Harper	Young	harper.young@corp.com
Joseph	Hall	joseph.hall@corp.com
